0000000000
0w000000w0
00ww000000
000w000w00
000w00w000
000w000000
000w00w000
000w000000
0000000000
0000000000