0000000000
0000000000
0000000000
0000000011
110000001F
F100000011
1100000000
0000000000
0000000000
0000000000